{
  "name": "极速通道",
  "chapter": 2,
  "spawnX": 1,
  "spawnY": 1,
  "mapLayout": [
    "####################",
    "#..+++.......+++...#",
    "#.#####.###.#####.##",
    "#.#.....###.....#..#",
    "#.#.###.....###.#..#",
    "#...###.###.###....#",
    "#++++......++++++..#",
    "#...###.###.###....#",
    "#.#.###.....###.#..#",
    "#.#.....###.....#..#",
    "#.#####.###.#####.##",
    "#..+++.......+++...#",
    "#.####.#####.####..#",
    "#..................#",
    "####################"
  ],
  "enemies": [
    {"type": "chaser", "x": 18, "y": 1},
    {"type": "chaser", "x": 10, "y": 7},
    {"type": "patroller", "x": 5, "y": 10}
  ],
  "items": [],
  "portals": [],
  "oneWays": [],
  "patrols": []
}
