{
  "name": "Bounce Maze",
  "chapter": 2,
  "spawnX": 1,
  "spawnY": 1,
  "mapLayout": [
    "####################",
    "#..................#",
    "#.####.####.####.#.#",
    "#..J...J..J...J..#.#",
    "#.##.########.##.#.#",
    "#..................#",
    "#.####.####.####.#.#",
    "#..................#",
    "#.####.####.####.#.#",
    "#..................#",
    "#.##.########.##.#.#",
    "#..J...J..J...J..#.#",
    "#.####.####.####.#.#",
    "#..................#",
    "####################"
  ],
  "enemies": [
    {"type": "chaser", "x": 18, "y": 1},
    {"type": "chaser", "x": 18, "y": 13},
    {"type": "patroller", "x": 10, "y": 7}
  ],
  "items": [],
  "portals": [],
  "oneWays": [],
  "patrols": []
}
