{
  "name": "Double Threat",
  "chapter": 1,
  "spawnX": 1,
  "spawnY": 1,
  "mapLayout": [
    "####################",
    "#..................#",
    "#.####.####.####.#.#",
    "#.#..........#...#.#",
    "#.##.####.####.##.##",
    "#......#..#........#",
    "#.####.#..#.####.#.#",
    "#......#..#........#",
    "#.##.####.####.##.##",
    "#.#..........#...#.#",
    "#.####.####.####.#.#",
    "#..................#",
    "#.##.########.##...#",
    "#..................#",
    "####################"
  ],
  "enemies": [
    {"type": "chaser", "x": 18, "y": 13},
    {"type": "wanderer", "x": 10, "y": 7}
  ],
  "items": [],
  "portals": [],
  "oneWays": [],
  "patrols": []
}
