{
  "name": "Hunter's Vision",
  "chapter": 3,
  "spawnX": 10,
  "spawnY": 7,
  "mapLayout": [
    "####################",
    "#........##........#",
    "#.####.#....#.####.#",
    "#.#....#.##.#....#.#",
    "#.#.##.#....#.##.#.#",
    "#....#.#.##.#.#....#",
    "#.##.#.#....#.#.##.#",
    "#..................#",
    "#.##.#.#....#.#.##.#",
    "#....#.#.##.#.#....#",
    "#.#.##.#....#.##.#.#",
    "#.#....#.##.#....#.#",
    "#.####.#....#.####.#",
    "#........##........#",
    "####################"
  ],
  "enemies": [
    {"type": "hunter", "x": 1, "y": 7},
    {"type": "chaser", "x": 18, "y": 1},
    {"type": "chaser", "x": 18, "y": 13}
  ],
  "items": [
    {"type": "magnet", "x": 1, "y": 1},
    {"type": "magnet", "x": 1, "y": 13}
  ],
  "portals": [],
  "oneWays": [],
  "patrols": []
}
