{
  "name": "地形大师",
  "chapter": 2,
  "spawnX": 1,
  "spawnY": 1,
  "mapLayout": [
    "####################",
    "#....+++..IIII.....#",
    "#.####.#.IIII.####.#",
    "#.#---.#.J..J#.---##",
    "#.#---.######.---#.#",
    "#..................#",
    "#.##.####..####.##.#",
    "#.++.#...JJ...#.++.#",
    "#.##.####..####.##.#",
    "#..................#",
    "#.#---.######.---#.#",
    "#.#---.#.J..J#.---##",
    "#.####.#.IIII.####.#",
    "#....+++..IIII.....#",
    "####################"
  ],
  "enemies": [
    {"type": "chaser", "x": 10, "y": 3},
    {"type": "chaser", "x": 10, "y": 11},
    {"type": "patroller", "x": 5, "y": 7},
    {"type": "patroller", "x": 14, "y": 7},
    {"type": "wanderer", "x": 18, "y": 7}
  ],
  "items": [],
  "portals": [],
  "oneWays": [],
  "patrols": []
}
