{
  "name": "生存竞技",
  "chapter": 5,
  "spawnX": 10,
  "spawnY": 7,
  "mapLayout": [
    "####################",
    "#........##........#",
    "#.######.##.######.#",
    "#.#....#....#....#.#",
    "#.#.##.######.##.#.#",
    "#...#..........#...#",
    "###.#.###..###.#.###",
    "#.......#..#.......#",
    "###.#.###..###.#.###",
    "#...#..........#...#",
    "#.#.##.######.##.#.#",
    "#.#....#....#....#.#",
    "#.######.##.######.#",
    "#........##........#",
    "####################"
  ],
  "enemies": [
    {"type": "chaser", "x": 1, "y": 1},
    {"type": "chaser", "x": 18, "y": 1},
    {"type": "chaser", "x": 1, "y": 13},
    {"type": "hunter", "x": 18, "y": 13},
    {"type": "hunter", "x": 4, "y": 7}
  ],
  "items": [],
  "portals": [],
  "oneWays": [],
  "patrols": []
}
