{
  "name": "Frozen Corridor",
  "chapter": 2,
  "spawnX": 1,
  "spawnY": 1,
  "mapLayout": [
    "####################",
    "#........IIII......#",
    "#.####.#IIII#.####.#",
    "#.#....#IIII#....#.#",
    "#.#.##.#....#.##.#.#",
    "#...##.......##....#",
    "#.#....#.##.#....#.#",
    "#.#IIII#.##.#IIII#.#",
    "#.#IIII#....#IIII#.#",
    "#...##.......##....#",
    "#.#.##.#....#.##.#.#",
    "#.#....#IIII#....#.#",
    "#.####.#IIII#.####.#",
    "#........IIII......#",
    "####################"
  ],
  "enemies": [
    {"type": "chaser", "x": 18, "y": 7},
    {"type": "chaser", "x": 10, "y": 13}
  ],
  "items": [],
  "portals": [],
  "oneWays": [],
  "patrols": []
}
