{
  "name": "地形大师",
  "chapter": 2,
  "spawnX": 1,
  "spawnY": 1,
  "mapLayout": [
    "####################",
    "#J.+++..IIII..+++.J#",
    "#.####.#IIII#.####.#",
    "#.#---.#....#.---#.#",
    "#.#---.######.---#.#",
    "#......J....J......#",
    "#.##.####..####.##.#",
    "#.++.#........#.++.#",
    "#.##.####..####.##.#",
    "#......J....J......#",
    "#.#---.######.---#.#",
    "#.#---.#....#.---#.#",
    "#.####.#IIII#.####.#",
    "#J.+++..IIII..+++.J#",
    "####################"
  ],
  "enemies": [
    {"type": "chaser", "x": 10, "y": 1},
    {"type": "chaser", "x": 10, "y": 13},
    {"type": "patroller", "x": 5, "y": 7},
    {"type": "patroller", "x": 14, "y": 7},
    {"type": "wanderer", "x": 10, "y": 7}
  ],
  "items": [],
  "portals": [],
  "oneWays": [],
  "patrols": []
}
