{
  "name": "First Encounter",
  "chapter": 1,
  "spawnX": 1,
  "spawnY": 1,
  "mapLayout": [
    "####################",
    "#..................#",
    "#.####.####.####.#.#",
    "#.#..........#...#.#",
    "#.##.########.##.#.#",
    "#..................#",
    "#.####.####.####.#.#",
    "#..................#",
    "#.##.########.##.#.#",
    "#.#..........#...#.#",
    "#.####.####.####.#.#",
    "#..................#",
    "#.##.########.##.#.#",
    "#..................#",
    "####################"
  ],
  "enemies": [
    {"type": "chaser", "x": 18, "y": 13}
  ],
  "items": [],
  "portals": [],
  "oneWays": [],
  "patrols": []
}
