{
  "name": "Patrol Maze",
  "chapter": 2,
  "spawnX": 1,
  "spawnY": 1,
  "mapLayout": [
    "####################",
    "#..................#",
    "#.##.####..####.##.#",
    "#.##.#........#.##.#",
    "#....#.######.#....#",
    "#.##.#........#.##.#",
    "#.##.####..####.##.#",
    "#..................#",
    "#.##.####..####.##.#",
    "#.##.#........#.##.#",
    "#....#.######.#....#",
    "#.##.#........#.##.#",
    "#.##.####..####.##.#",
    "#..................#",
    "####################"
  ],
  "enemies": [
    {"type": "chaser", "x": 18, "y": 1},
    {"type": "patroller", "x": 5, "y": 7},
    {"type": "patroller", "x": 14, "y": 7}
  ],
  "items": [],
  "portals": [],
  "oneWays": [],
  "patrols": []
}
